2222222C2222222
300000010000003
011111111111110
010101010101010
010101010101010
010101010101010
010101010101010
010101010101010
2S2S2S2S2S2S2S2