2222222C2222222
000000010000000
011111111111110
010101010101010
010101010101010
010101010101010
010101010101010
010101010101010
2S2S2S2S2S2S2S2