2C2222222222222
010003333333333
011103333333333
010103333333333
010103333333333
010103333333333
010103333333333
010103333333333
2S2S22222222222